107
9
23 24 24 24 24 24 24 24 24 24 24 24 24 24 24 24 24 24 24 24 24 24 24 24 24 24 24 24 24 24 24 24 24 24 24 24 24 24 24 24 24 24 25 03 22 22 22 22 22 22 22 22 21 21 22 21 22 22 22 22 22 22 22 22 22 22 22 22 22 22 22 22 22 22 22 02 23 24 24 24 24 24 24 24 24 24 24 24 24 25 03 22 22 22 22 22 22 22 22 22 22 22 22 22 22 22 22
28 00 00 00 00 00 00 00 00 00 00 00 00 00 00 00 00 00 00 00 00 00 00 00 00 00 00 00 00 00 00 00 00 00 00 00 00 00 00 00 00 00 00 00 03 22 22 22 22 22 22 22 22 21 22 22 21 22 22 22 02 00 00 00 00 00 00 00 00 00 03 22 22 22 22 02 00 00 00 00 00 00 00 00 00 00 00 00 00 00 00 03 22 22 22 22 07 00 00 00 00 00 00 00 00 03 22
28 00 00 00 00 00 00 00 00 00 00 00 00 00 00 00 00 00 00 00 00 00 00 00 00 00 00 00 00 00 00 00 00 00 00 00 00 00 00 00 00 00 00 00 00 00 00 00 03 22 22 22 22 22 21 22 22 22 22 22 02 00 00 00 00 00 00 00 00 00 00 00 03 22 22 02 00 00 00 00 00 00 00 00 00 00 00 00 00 00 00 00 00 00 00 00 00 00 00 00 00 00 00 00 00 03 21
28 00 00 00 00 00 00 00 00 00 00 00 00 00 00 00 00 00 00 00 00 00 00 00 00 00 00 00 00 00 00 00 00 00 00 00 00 00 00 00 23 24 25 00 00 00 00 00 00 00 00 00 00 00 00 00 00 00 00 00 00 00 00 00 00 00 00 00 00 00 00 00 00 00 00 00 00 00 00 00 00 00 00 00 03 21 21 21 21 02 00 00 00 03 22 22 22 02 00 00 23 24 25 00 00 03 22
28 00 00 00 00 00 00 00 00 00 00 00 00 00 00 00 00 00 00 00 00 00 00 00 00 00 00 23 24 24 25 00 00 23 25 00 00 00 00 00 00 00 00 00 00 00 00 00 00 00 00 00 00 00 00 00 00 00 00 00 00 00 00 00 00 00 23 24 24 24 25 00 00 00 00 00 00 00 00 23 24 25 00 00 00 00 00 00 00 00 00 00 00 00 00 00 00 00 00 00 00 00 00 00 00 03 21
28 00 00 00 00 00 00 00 00 00 00 00 00 00 00 00 00 00 00 00 00 00 00 00 00 00 00 00 00 00 00 00 00 00 00 00 00 00 00 23 24 25 00 00 00 00 00 00 00 00 00 00 23 25 00 00 23 25 00 00 00 00 00 00 00 00 00 00 00 00 00 00 00 00 00 00 00 00 00 00 00 00 00 00 00 00 00 00 00 00 03 22 22 02 00 00 00 00 00 00 00 00 00 00 00 00 26
28 00 00 00 00 00 00 00 00 00 00 00 00 00 00 00 00 23 25 00 03 21 21 21 21 02 00 00 00 03 21 21 02 00 00 03 21 21 02 00 00 00 03 21 21 21 02 03 21 02 00 00 00 00 00 00 00 00 00 00 00 03 21 22 22 02 00 00 00 00 00 00 00 00 03 21 22 02 00 00 00 00 00 03 21 21 21 02 00 00 00 00 00 00 00 00 00 00 00 00 00 00 00 00 00 00 27
24 24 24 24 24 24 24 25 00 03 21 22 22 22 22 22 02 00 00 00 03 22 22 22 22 21 21 21 21 21 21 21 21 21 21 21 22 22 02 00 00 00 00 00 00 00 00 03 21 22 22 21 21 22 21 22 21 21 22 22 21 21 22 22 22 02 00 00 00 00 00 03 21 21 21 22 21 21 21 21 22 21 21 21 22 22 22 21 21 21 21 21 21 21 22 21 21 22 21 21 21 22 21 21 21 21 21
00 00 00 00 00 00 00 00 00 00 00 00 00 00 00 00 00 00 00 00 00 00 00 00 00 00 00 00 00 00 00 00 00 00 00 00 00 00 00 00 00 00 00 00 00 00 00 00 00 00 00 00 00 00 00 00 00 00 00 00 00 00 00 00 00 00 00 00 00 00 00 00 00 00 00 00 00 00 00 00 00 00 00 00 00 00 00 00 00 00 00 00 00 00 00 00 00 00 00 00 00 00 00 00 00 00 00